11110111111
10011011010
11001010110
11101111011
10111001101
11001110110
01110010111
01001111001
11011011111