11101101101010
10111010111110
11011011011011
11101110111011
00110100110001
10101011010101
11111111011111
10110110110000
11011011011110