1111110101101
1011011111111
1101111000101
0110010110101
1111111111101
1011001001111
1001111011100
1111001010101
1001101110111