1110111101
1000110101
1011110101
1110010111
0000010001
1111110011
1110011011
1110011111
0011110000
0110011111