111110011010
110010011111
011011010100
011011110111
001110111011
111100011110
100111110011
100110101101
111100111011
000110101010